a=i
the=to
of=and
in=is
it=for
that=if
you=this
be=on
with=not
have=are
or=as
from=can
but=by
at=an
will=no
all=was
do=there
my=one
so=we
they=what
would=any
which=about
get=your
use=some
me=then
name=like
out=when
up=time
other=more
only=just
end=also
know=how
new=should
been=than
them=he
who=make
may=people
these=now
their=here
into=first
could=way
had=see
work=well
were=two
very=where
while=us
because=good
same=even
much=most
many=such
long=his
over=last
since=right
before=our
without=too
those=why
must=part
being=current
back=still
go=point
value=each
did=both
true=off
say=another
state=might
under=start
try=website
webmaster=vnode
undesirables=tradeshow
toolchain=telecommuting
teTeX=sysinstall
struct=strncpy
strcpy=standalone
sprintf=snprintf
shareware=sgml
sed=screenshots
screenshot=playlist
plaintext=patchkit
passphrase=newbies
netmask=netgraph
multithreading=mislabeling
misc=microuptime
malloc=majordomo
libc=journaling
ipfw=installathon
init=infrastructural
iXsystems=httpd
framebuffer=excerpting
eBones=eBay
draconian=downtime
diffs=diff
dialup=devfs
contrib=committers
cleartext=bytecode
benchmarked=awk
advisories=ZDNet
Xeon=XTerm
XMMS=XFree
XDM=WordPerfect
Wemm=WEP
WAV=Vinum
Vidrine=Vaschetto
Valentino=VPN
VM=VLB
VFS=VESA
UltraSPARC=Ukraine
UTP=UTC
USB=UID
UFS=TrustedBSD
TrueType=Tk
ThinkPad=Tcl
TRB=Sybase
Sutter=SunOS
StrongArm=Stokely
StarOffice=SoundBlaster
Sony=SoftUpdates
Slovenia=Slackware
Siemens=Shumway
SVR=SSL
SSH=SQL
SNMP=SMP
SMB=SGI
SDRAM=SCO
Romania=RedHat
RealPlayer=RSA
Quicktime=Qt
QIC=PowerPC
Postgres=PostScript
PnP=PicoBSD
Photoshop=Perl
PXE=PR
PPPoE=PPC
PLIP=PID
PDF=PCI
PAE=OpenSSL
OpenSSH=OpenOffice
OpenGL=OpenBSD
OSnews=OSF
OPIE=Novell
Nokia=Newsflash
Newbus=NetBSD
NetBIOS=Nasdaq
NTP=NT
NSSwitch=NSS
NNTP=NIS
NIC=NDIS
NAI=MySQL
Mozilla=McKusick
Matrox=Mathematica
MathWorks=Maplesoft
Mallett=Macromedia
MUA=MTA
MPEG=MP
MIPS=MFC
MBone=MBR
LinuxDoc=Lehey
Leffler=LPR
LPD=LOMAC
LLC=LGPL
LDAP=LAN
Kuriyama=Kerneltrap
Kerberos=Kennaway
KSE=KOffice
KLD=KDE
JadeTeX=JVM
JSP=JRE
JDK=Itanium
Iomega=ISP
ISDN=ISBN
ISA=IRQ
IRC=IPsec
IPX=ICMP
IBCS=Hubbard
Hotmail=Haynes
HTT=Greenman
Ghostscript=GPL
GEOM=GDBE
GCC=Fry's
FreshPorts=FreeBSD's
FreeBSD=FireWire
FDDI=Euro
EtherExpress=Estonia
Ermilov=Ensoniq
EISA=EIDE
DocBook=Dilbert
DVI=DVD
DTD=DNS
DEVBUF=Compaq
CompUSA=Chern
Celeron=CVSup
CVSROOT=CVS
CTM=CPAN
CERT=CDs
CDROMs=CDROM
Broadcom=Border's
Bluetooth=BeOS
Barnes=BSDi
BSDCon=BOOTP
BOFs=BIBA
Athlon=Appletalk
AlphaBIOS=AfterStep
AXP=AVI
ATX=ATAPI
APIC=API
AMD=AGP
ADSL=ACPI
ACL=ABI
